{
  "characters": {
    "4210101021": 4204000001,
    "4210501021": 4204000002,
    "4220301021": 4204000003,
    "4220301011": 4204000004,
    "4240301011": 4204000005,
    "4230101021": 4204000006,
    "4230401011": 4204000007,
    "4250101021": 4205000001,
    "4250201021": 4205000002,
    "4210301021": 4204000008,
    "4240201021": 4204000009,
    "4250102011": 4205000003,
    "4260102021": 4205000004,
    "4220502021": 4204000010,
    "4210402011": 4204000011,
    "4240202011": 4204000012,
    "4230302021": 4204000013,
    "4260502021": 4205000005,
    "4230202011": 4204000014,
    "4240502021": 4204000015
  },
  "weapons": {},
  "materials": {}
}
